SO ./img/purple_wall.png
NO ./img/blue_wall.png
WE ./img/grey_wall.png
EA ./img/yellow_wall.png

F 220,100,1
C 225,30,0

1NE11111111111111111111111
1000000000110000000000001
1011000001110000000000001
1001001111111110000000001
1111111       10001110000000000001
100000111111111001111111111111111
11110111111111101110000011111
11110111111111011101010010001
11000000100101011100000010001
10000000000000001100000010001
10000000000000001101010010001
1100000111010101111101111000111
11110111 1110101 101101010001
11111111 1111111 111111111111
