SO img/purple_wall.png
NO ./img/blue_wall.png
WE ./img/grey_wall.png
EA img/yellow_wall.png

F 50,50,50
C 255,150,255

11111111111111111111111111
1000000000110000000000001
1011000001110000000000001
1001001111111110000000001
1111111       10001110000000000001
1000001111111111001111111111111111
11110111111111101110000011111
11110111111111011101010010001
11000000100101011100000110001
1000000000000000110000100010111
10000000000000001101011101 101
110000011101010111110002011111
1100111 1110101 1011010100N01
110111111 1111111 111111111111
